0, 0, 0, 26, 34, 26, 0, 0, 0, 0,
0, 8, 9, 62, 2, 62, 8, 9, 0, 0,
0, 16, 41, 40, 3, 40, 41, 17, 0, 0,
37, 10, 45, 3, 60, 3, 45, 11, 39, 0,
0, 16, 5, 3, 45, 3, 4, 17, 0, 0,
0, 0, 16, 18, 3, 19, 17, 0, 0, 0,
0, 0, 0, 0, 36, 0, 0, 0, 0, 0