8, 40, 1, 39, 34, 0, 0, 0, 8, 9,
58, 45, 9, 8, 40, 11, 9, 0, 2, 2,
16, 13, 56, 58, 2, 16, 45, 57, 3, 17,
8, 21, 2, 16, 45, 10, 17, 0, 2, 0,
56, 4, 4, 1, 5, 45, 59, 1, 3, 9,
62, 16, 45, 1, 40, 57, 1, 1, 45, 40,
16, 1, 17, 0, 16, 41, 1, 61, 19, 17