37, 1, 1, 1, 9, 25, 1, 9, 0, 38,
0, 8, 1, 1, 40, 1, 1, 45, 1, 17,
0, 2, 0, 0, 2, 0, 0, 2, 0, 0,
0, 20, 9, 0, 32, 33, 1, 40, 9, 0,
25, 44, 40, 1, 35, 34, 0, 2, 2, 0,
8, 40, 17, 0, 0, 2, 0, 2, 2, 0,
36, 16, 1, 1, 1, 40, 1, 19, 18, 39