0, 0, 0, 30, 0, 0, 30, 0, 0, 0,
0, 29, 1, 44, 1, 1, 44, 1, 31, 0,
0, 0, 0, 62, 0, 0, 2, 0, 0, 0,
33, 1, 1, 44, 1, 1, 44, 1, 1, 39,
0, 0, 0, 2, 0, 0, 62, 0, 0, 0,
0, 29, 1, 44, 1, 1, 44, 1, 31, 0,
0, 0, 0, 28, 0, 0, 28, 0, 0, 0