0, 0, 8, 10, 1, 10, 1, 10, 9, 0,
0, 0, 16, 60, 1, 44, 1, 60, 17, 0,
0, 0, 0, 2, 0, 2, 0, 2, 0, 0,
33, 1, 1, 44, 61, 60, 1, 44, 1, 39,
0, 0, 0, 2, 0, 2, 0, 2, 0, 0,
0, 0, 8, 60, 1, 44, 1, 60, 9, 0,
0, 0, 16, 18, 1, 18, 1, 18, 17, 0