0, 0, 34, 0, 8, 1, 9, 0, 38, 0,
8, 1, 3, 1, 44, 1, 44, 1, 3, 35,
2, 0, 2, 0, 62, 0, 2, 0, 2, 0,
16, 1, 3, 1, 44, 1, 3, 1, 44, 9,
0, 0, 2, 0, 2, 0, 2, 0, 2, 2,
37, 1, 44, 1, 3, 1, 44, 1, 3, 17,
0, 0, 16, 1, 17, 0, 16, 1, 17, 0