0, 0, 0, 8, 10, 1, 1, 9, 0, 0,
33, 1, 10, 40, 21, 0, 0, 16, 1, 39,
33, 1, 40, 16, 44, 1, 1, 1, 1, 39,
33, 1, 18, 10, 40, 8, 1, 1, 1, 39,
33, 1, 1, 40, 40, 17, 8, 1, 1, 39,
0, 0, 0, 16, 1, 1, 17, 0, 0, 0,
0, 0, 0, 0, 0, 0, 0, 0, 0, 0