0, 0, 0, 34, 0, 0, 38, 0, 0, 0,
0, 0, 0, 2, 0, 0, 2, 0, 0, 0,
0, 8, 1, 13, 0, 0, 12, 61, 9, 0,
25, 44, 1, 44, 1, 1, 44, 1, 44, 27,
0, 16, 61, 21, 0, 0, 20, 1, 17, 0,
0, 0, 0, 2, 0, 0, 2, 0, 0, 0,
0, 0, 0, 36, 0, 0, 32, 0, 0, 0