6, 40, 1, 1, 9, 8, 1, 1, 41, 6,
16, 17, 0, 0, 2, 2, 0, 0, 16, 17,
37, 1, 1, 1, 45, 45, 1, 1, 1, 39,
33, 1, 61, 1, 45, 45, 1, 61, 1, 35,
37, 1, 1, 1, 45, 45, 1, 1, 1, 39,
8, 9, 0, 0, 2, 2, 0, 0, 8, 9,
6, 41, 1, 1, 17, 16, 1, 1, 40, 6