33, 1, 9, 0, 0, 0, 0, 8, 1, 35,
8, 1, 40, 1, 9, 8, 1, 43, 1, 9,
12, 61, 5, 1, 45, 44, 1, 4, 61, 13,
57, 1, 58, 1, 56, 56, 1, 58, 1, 59,
2, 0, 2, 0, 2, 2, 0, 2, 0, 2,
41, 1, 45, 1, 21, 20, 1, 44, 1, 40,
36, 0, 16, 1, 40, 42, 1, 17, 0, 36