0, 0, 0, 0, 0, 0, 38, 0, 0, 0,
8, 1, 1, 9, 0, 0, 2, 0, 0, 0,
2, 37, 1, 40, 1, 1, 44, 1, 35, 0,
16, 1, 1, 3, 61, 1, 3, 1, 1, 9,
0, 33, 1, 44, 1, 1, 40, 1, 39, 2,
0, 0, 0, 2, 0, 0, 16, 1, 1, 17,
0, 0, 0, 36, 0, 0, 0, 0, 0, 0