0, 0, 0, 0, 34, 34, 0, 0, 0, 0,
37, 1, 9, 0, 2, 2, 0, 8, 1, 39,
0, 8, 45, 1, 60, 60, 11, 45, 9, 0,
0, 62, 2, 8, 60, 60, 17, 2, 62, 0,
0, 16, 45, 18, 60, 60, 1, 45, 17, 0,
37, 1, 17, 0, 2, 2, 0, 16, 1, 39,
0, 0, 0, 0, 32, 32, 0, 0, 0, 0