0, 0, 0, 38, 38, 38, 38, 0, 0, 38,
0, 0, 0, 2, 2, 2, 2, 0, 0, 0,
29, 1, 1, 44, 44, 44, 44, 1, 1, 35,
29, 1, 1, 44, 44, 44, 44, 1, 1, 35,
29, 1, 1, 44, 44, 44, 44, 1, 1, 35,
0, 0, 0, 2, 2, 2, 2, 0, 0, 0,
0, 0, 0, 36, 36, 36, 36, 0, 0, 0