0, 0, 33, 9, 0, 0, 0, 0, 0, 0,
0, 0, 0, 12, 1, 1, 9, 0, 0, 0,
0, 0, 0, 2, 0, 0, 2, 0, 0, 0,
0, 0, 0, 2, 0, 0, 62, 0, 0, 0,
0, 0, 0, 2, 0, 0, 2, 0, 0, 0,
0, 0, 37, 40, 1, 1, 17, 0, 0, 0,
0, 0, 0, 0, 0, 0, 0, 0, 0, 0