0, 0, 0, 0, 8, 9, 26, 0, 0, 0,
0, 0, 0, 0, 2, 2, 2, 0, 0, 0,
0, 0, 0, 0, 62, 2, 62, 0, 0, 0,
33, 1, 1, 1, 44, 44, 44, 1, 1, 39,
0, 0, 0, 0, 2, 62, 2, 0, 0, 0,
0, 0, 0, 0, 2, 24, 2, 0, 0, 0,
0, 0, 0, 0, 16, 1, 17, 0, 0, 0