8, 61, 40, 1, 9, 0, 8, 1, 1, 9,
16, 1, 13, 8, 44, 1, 3, 1, 1, 17,
29, 1, 44, 21, 36, 37, 44, 11, 1, 35,
29, 1, 3, 44, 39, 38, 20, 3, 1, 35,
29, 1, 44, 17, 8, 44, 19, 3, 1, 35,
0, 0, 2, 0, 16, 3, 1, 17, 0, 0,
0, 0, 16, 1, 1, 17, 0, 0, 0, 0