0, 0, 0, 0, 34, 0, 0, 0, 0, 6,
0, 0, 8, 1, 3, 1, 1, 1, 1, 40,
0, 0, 2, 0, 12, 1, 1, 1, 1, 17,
0, 0, 40, 1, 44, 1, 9, 0, 0, 0,
0, 0, 2, 0, 2, 0, 2, 0, 0, 0,
0, 0, 36, 0, 2, 0, 36, 0, 0, 0,
0, 0, 0, 0, 32, 0, 0, 0, 0, 0