8, 1, 1, 1, 1, 1, 1, 1, 9, 38,
20, 42, 1, 1, 1, 1, 1, 9, 2, 0,
2, 20, 42, 1, 1, 1, 9, 2, 2, 0,
56, 56, 56, 33, 1, 9, 2, 2, 2, 0,
2, 2, 16, 1, 61, 19, 3, 3, 40, 39,
2, 16, 1, 61, 1, 1, 17, 2, 0, 0,
16, 1, 61, 1, 1, 1, 1, 17, 0, 0