0, 0, 0, 0, 38, 38, 0, 0, 0, 38,
0, 8, 11, 11, 21, 20, 11, 10, 9, 0,
0, 20, 40, 40, 40, 40, 40, 40, 13, 0,
0, 12, 40, 6, 3, 3, 6, 40, 21, 0,
0, 12, 40, 40, 40, 40, 40, 40, 13, 0,
0, 16, 17, 2, 2, 2, 2, 16, 17, 0,
0, 0, 0, 32, 32, 32, 32, 0, 0, 0